1111111111111
100100P000000
1C00011111001
100011E000001
1111111111111
