1111111111111
100100P0000C1
1000010111001
100010E000001
1000110000001
1111111111111
