11111111111111111111111111111111111111111111111111111111111111111111111111111
10000100011000000101001001010000101011010000000000001001110001101000100000001
1000C0000010000011010000100001010000000010C010100000000001001C010000010000001
1110011101P0100001001000000000000100000001011011001001100001000100110001100C1
10000111000C1111001000C000100110101000C01000000000010011010000001100100000111
10101101000100010110001000000101100100001000100101000101111100100010000110001
10111001000000100000100000101110010100011100000000110011100000101101001100001
10000001000000000010010010000110000011000000111001000011110000000001000001001
100110000010000000001111110010101000000011011000011C1101000100011100101001001
101C0000111001001101000001011000111000000000011000101000000110100100101000001
11110000000110111000100000100001100101110101010100111001000101011000000100101
1100011C01000000100001100010010C000100100000111000C00000001101C01001000100001
100010000110C010110111000001000C000000010C0000100100000000000010000C001000101
10000000011101110000C10000010111010111011000100010000110010000010001000001001
11011000001100000000000010010000001100001010000110011000100010010101010000001
1110001111000000000000100000100000000101001100C000000100010000010010010000101
10001000011010001010101111000000100010111101000100101001100010000011100100001
10000000000010000000000011100000000101001000010111100110100010000001000100101
1C000000000100001001011000000000100110111010010010000110100000010001010000001
100011101000000100100100000001001010001000001000001101000000010001010100100C1
11010001001E000010100100010000011001000000000001010100100100101000100101001C1
111111000110000011010010001001010011101010000C10101110011CC101101001001000001
100001000010110100100C00C00000100000101001101000000101010001000000010011C0011
11111100100010000010001100000100011001010000001110100010100001001001010000001
1010000C01000010000010C100000010000100000010110010100011010101101001010010001
110100000101010101C1000010100001111001000110010000000110001010000000010101001
110110000110000000101C001100001000010011010001C000000000C00010011100001000101
10000110001111000011000001000001000101100001010000101011C01000000000010000101
11101100011000C010011000001001100001CC000111001101001010001011010000100000001
10101001100000010000010000000001000010000101010010100000001000001000110110111
10001001000110000100001000001100000010000C00000000100001000100000101000000001
101111000000010100000001000000001000010000000000111010C0000100101101000011101
101010001C1000010100100001010000011000010010000000010001110010010110000110011
101000000001010000010010000010010001000100010000000C01110000C1010101110010011
10000000100000001000000100000010000000011010000100001001011000100000100110101
1010C000110010000000000010101100000000001000000000110C11100010C00000100000001
1000010111011001001011010100000000000000111101000000000100100101010C010001111
1100001001000101010101101001100001C100000000001000000010000110100000010000011
10100100001100011000010001000000010001000000110000000000000100000000001010001
10000010011011010001001100011000100000000010000100000010001100000001100000101
1001100010000011000100010100000001000011C01C110011000000100011100110100100001
11111111111111111111111111111111111111111111111111111111111111111111111111111
