1111111111111111111111111111111111111111111111111111111111111111111111111111
110000000010000100C1100100010010001000C1010011110010010110000100010100110001
1010110000100000001000100000000100101100011001110011000000000011100010101001
1C01000000010110001C10011000C00111001010001101100011001100001010100010000001
10011010010110000100100000111101000110010C0010001111100000111001000101100001
10000100000100100001100000101010C0100100000100010010110100101001000000000101
1000010000C01100000001100010000010001000010001100100101001101001101100000001
10C0000000111001000000C01010010000000100001010100000100001000001100100101101
10010010010011100000000C001100000001001C0100101010001101001001000000C0001101
10C1001000011000001000000000001000010101010110100110001000000000000010100101
101000010C011000000100000000100000001110010101101000100111001011000001000011
11000100111C10000000110101100000C0001110100000000110000010001100100000110001
10100001C100110101000000010000111C101110011011010001000100001010000000000011
1101010011000110100000000000000111010100010000101011000000000000111111000001
111101011001010000110000C11110101011000000000110C111000001010000101001011011
101000100110C000010010000011100000110010001000C00110100000110010000000111001
1001001100101011010000010010100000001001100001100000001101110000001100100011
1010000000011010010001000001000001100110110101100000001111001001010101101111
10C00100000100000110010000C0111010010101001001101010110001000C00000000110001
1000000101010100100111000100011001000001111010000010000000010011101001001011
1010000001011001011101000001010101010101100100000000000001011000100001000101
1000100111001011100001001110000000001000010000001000000101100000000110010011
100010001010000100100001110000000100000000101100111011C1001000001010110010C1
101000C000000100101100010000011000011000001100001001000000100001000001000101
101C000010001000000000001100000000010010010101000001001011011101000111100001
10111001000010100110000000000001011110110100C010000P010000110000100100001001
111110001010000000C101100111100001001000100011001001110010000001100001000011
1110000001000100000011001000100010001000000000100010011001001111101000110101
10001010001100101000111000010100010000010101C1C01001110000000100000110010101
111110111010000101011111100110100100C00000000000001000101110100C001100000101
100000000001010100100000011000000000100C000011110010011001011000001001C01101
101010000011100111001010100101101000101000100001100011000C100100000001000111
1100011000100100001000000100100001001000011000000100000010111100000000000001
11000100110000C0000010100001010010000000110100011001110010100010101100000011
10110010011101000C00100000000111100001C0E01010000000000000100000000000010011
10010100000001101101100001110000000C0000010001010001100010010110100010011001
11100100110000C010101000100101100001001011100001000001000000C010000000010011
1101000000100000100000000111001000001001001001111000100101100100001101010001
10100001001000001011001000000000000010100001001011000C1000101000100111100011
1000100000001110001010001100101000001011101000101010010100000001010000110001
1000100011100000100000000001000000C1000000010CC00000010000110110C00000110001
1111111111111111111111111111111111111111111111111111111111111111111111111111
