1111111111111
1P0000E000001
1111111111111
