11111
1P001
1E001
1C001
11111
