11111111111111111111
10001000100000100001
10100010001011001101
10011100100100010001
11000001000001000101
10010100011110110001
10100001000000001001
1P100110001101100101
10001000110000010001
10110001001011001101
10000100100100000001
11001000010001011101
10100011100110000001
10001000001000100101
10110100110011010001
10000001000100001001
11001100011001100101
1E000010100010000001
10110001001100011101
11111111111111111111
