1111111111111111111111111111111111111111111111111111111111111111111111111111111111111111111111111111
1100000000100010010000000000100000000000000110010100000011010001100101000100000001100010001000100001
1010001000010101000001000101000100000000010001101110000000001111100010000010001001010000001110000011
1010001010100011010000100001001010010000010010010100000000000011000000010101010001010000010111011101
10001101000100001110011000000110000000001100C1001000000010101010000000001000001100000001101000101011
1001000000010110100000111100001000010001010100001000100011000000011100001000001001000100100110001001
10000011011000001000000C0010000000100000010001010000000000000010101110000000000010010110010100001111
1010011000100001110001000010011010C11000000011011010101101100010111000100000000000001C11000001010101
100110000110011111000000000100001000010101110101011010100000010001001000110100100100011C000100001111
1100110000100000000000110111111100110010000110001010100001010C01000000000000100101101100001000110001
1000001000001100000110010000100000101001000001000010011110001011001000001001010110001100100011101011
1110000000001000000001101000011000000001100000110100000010000000011000100000000000000001111000001001
1001111000100000110010100000110110110001000000001001000100101001000100010000001110100001000000011001
1001100100101100001100010000110110C010000000010100001001101011011000000010C0011100111000001001100001
1010000010100000001001000000100100000001010100011000100100000010001100001000100001010011111100001001
1000101010110010100100010010000100001100000110010001100010001011000000101101000100100000000000100101
1000000010101110000100100000010000110000000000100100010000011010001000100010010000000100C10100100101
1110101000010000100110000001000111000111110010000100000100010000100010001111011000001000001101001001
1100000000011000010000000011000001011000001000110001011000010110100001001010100001001000001100111011
10010111010101000100000000011110110001010000000001010000010100000010001111010100100101100000000C0101
1100000100100000010000100000100100001011000100010001101111000100100010000011101000001100100100011001
1010010000000000110101000000000010000100000000011010010001100000011000001000100010010000101010110011
11101001010C1100000010100011000100000C00110100111000101110010111001000111100001001000000000000101001
11100100111C0000011100110000010001000000001101000100100000111010C10001001100010001110001110001000101
1000000011100000000100100010000000000000101011000100001000000000010000010001010000000000000100001111
1100101110000000000110101000101000000100100000010001000010000010000000100000101000011000110110100011
1000011000101011011001000100001100001001000000000011010001000000010C10000001010101000011000111010011
11000000110001001001100111101000000100001010111C0101110001110001001100010001000011001000100000010001
1110111001000100010000000000000110100000001111100100100001001011101001000100000011010000000001000101
1100000100000101000000100001000111000000011001100100110000C01001001000001000011010000010010000001001
10000010100000100100100000011000001010001011000100001100001000110001000010C0000000010000101000001001
1100000100000000100100000001000001100000000010011010110100001010000000100001011100010001011000000001
11001011010110000110000011101000000000110000100100000100C0000000011100001111000101101000000101000111
1011010000000100100000010000010000010011001011000001010010100010100110010000001011000110110011000111
1000001010100010100000100001110000000010001000010100110000001001100000E01101010100000110110000010001
101C101101000000001110010000001010001000100010000110000000000010011010010100101001100101000000010111
10000000001011010000000011100000100000000000100001100000100100010000000000110001100000000000000000C1
1001000011101001101110110001001101101000100000011101000010000010000011000001000100001010110010100011
1000100000100100100100000000000110101000010100011100100001101010000110011001001001011000011001110101
10000000010110001000000111C1010100100001000100000C00001000001000101000011000100000000001111010100011
1010001000001000001000100001001000101100010001110001100000000001100010001000110011100110000100110101
1000001000000100010100101011110000111000001000010001000001100000010100011010111000001000000000010001
1101C00001000001000101000010001010000101001001000010000000000100000001000100110000100001000110101011
1110100001001100100000111000000001000000010000010100000001100100010000011100101000110000011101010001
1001000000000000100001000010100010100101001000101010100000100100001111101000000110000010000000001001
1001001011010000000100101000010001000000110010000001001000001010000010110010101001000001100011100001
1010000001100000001010010000011101000010100001100010010001000111100010000000000110000111010011100001
1100000010100010100000000000101000010000000000011000010100100111011000001001000110101110000001101101
1010001010000000000000000100000010100000101001000010000010011000000000100100001010000000010110101101
1001000010000011000011010010101101001001011010010000010001001011010000000010110011000001001000010001
1001110001100001011000001011000011000101010000000100000100010000000010010000000110101000000100100001
1000101100110100011000000000000000110000000010001101010111100110000100100100000100000100010001000101
1100010011000011100111101110000100010000000000100010001000011000100100100000100001110011010000010011
1010000010010001110001010011000000100000100101110000010000000101001000010010101010000100100000100101
1010101011000010000001011000011010010010010001000111000101110000000001000000010000100110000101001001
1001100011010001011000011000010000000000100100001000010000000000101001000011000000011100000000011111
10000C000000010100011100001111000100000000100010000000100100011000010C001000000010010100010000110101
1010010011110010000101000000100000011110000000001000000000100100000110101000000000010010000000000001
1000010000000001000000000000000001001001001000011010000110011001000001001000000001110010000000000001
10110011100100000C1111100000001100010001001001100000000001101010000101101110001111010101010000000001
1000101100000100000001100110011000000010010000100001100011110011001010000110001010000000000000011001
1010011010101000010000000111000000100011000101101011000011011100000100000111010100010100001000110101
10000000001000011000001000011001C0110000010001000100000011001100000011001100010000100110011010001001
100110011001010001101000100001100000000110001011010000010100000000100110101C010101000010001010010101
1000001100000100000100100000000000010001000011100000000010100000100000000010011000010000000010000001
1011001101000000010000000000000000010001000000010000000100010101100000100000110010110111000011011001
100101111011011101000000101011011C0110000000001110110010011001000111100001P0000100011000000000001001
1001111110000100011000000010001010000101000110100000010101000100000110001100000011000010011000010001
1001100110010000010001010000000000001010100101111000000000001000000000010010010000110000101010000011
1110000010001100100010000110011100000000000000011000101010000001100000000000100000000000100010000011
1101100100001000101000010001000010000001100001C00001000000000010000100000000000000110011010000010001
10000011100000000000000001100111010101000000010010C0000010000100001101000001110110101110001100010001
1110111001001000001100111100101000110000000000000000000000000000001000011010100001000100000000100001
1001000000001101000010100110101000001100000010100000001010010000011000000000001000000001000101000001
1000010110000000010111010011011000100000000011110001010010000000000100000001000000000000000100000001
1000000000010000100001011011000C11101000010101001011010000000101001011000010000011100000000000000001
1010000101000111001000101100100000000001001000000100100011110010010000001000000100000000100100110001
10001010010000000100010000110000000001001C0100000000000111110010100110000000010010000100101011001111
1001110001000011000001000000010011010C010010011101101000011000011000010011C0001100010101101100100011
1001010100001000100001011000011001000000000C01101101010001000100000000110000010101000000100000000001
1000C00100010110000110010100110001011000010010000000000000011100000100C0000C010100010010100010000101
101100000101001000000110000100101C100100001001001000001011001101000000010001000011100010100000000001
1010111000100000000001000010001001001101000010111001001101000001001000000100010000001001000000110001
1000001000000001010000000000100000010000000100001110000111001100110100000001000010000110000000110101
10100000011011101100001000010000000000010100010110010010100110101010100011001001000100C1101000010101
1100001000000011000101001110000100100011000110000010000000001100100001100110011001000001111000000001
1110000000001100101000000000100000010000000000010110000010100110000101000100111011000100101100100101
1110101000001000001000100010111010010101010001000010000110000000010011100000100000001110010010100001
1000110110101001011001100011100001000010101000000001000101001100010010010001000000101100010000000101
100010000001000001000010011000000000000100100101000C101010110011101010000000000001000000000100000001
1001001010011110001011110000110000000010000100001100000000011000001010000010001000100100000000001001
11000010100010010000111000100000100011100100100000000001100000100000010100001110C1100000000000000001
110000011000000000110000100000110001000101010C000001100100100010000000100100000111001010000010010001
100010100000101010101000001000011011011111100000110000110011100000C001110101000000011010010000000001
1000011000111000000010111001000011100000010000000111000000001000010010001000000000C00001010101100001
10010000001100011000001001000011001C0100101000101000101000110001001000000000100100000001011111000101
1000001010100011010010011110111000110101000001000000010000010000101010000100000000100001000001100111
101000C000001000100101010010001101001010100001011001011100000100001111000110001010101001001001000001
100001001000110000110110100000001100001010100010001010100C110010001000010000000100010000000011100011
1111111111111111111111111111111111111111111111111111111111111111111111111111111111111111111111111111
