1111111111111111111111111111111111111111111111111111111111111111111111111111111111111111111111111111
1000001000101010100000001000000100000100000101011010100000000100001000101011011100000001111001100001
1001100010100000001101001100100110000000001111000001011001010001011111100001000000110011000000111001
1011100000000100010010000100000100000100100000011101000000000100C10000010000011000001001001000100001
1000000101000010001010100000011001000000001110000100000100C00110000010110000000011010011011000100011
1100001000001010000001001111101011001101010011111000010001101011010000011010000010101110000010010001
1001111100000010001100100110100010011101010000101001001001011001000000000101100001000110011100011001
11110001C1101000000111010000100010010000001100001000C10111101000000010000000000001000000110000011001
1001000000001010101010010001001001010000001000100010001010101000110010000110000000110000000010010001
1000100011010101000001101011100010000C01000010001100000101000101100110000101000010000000001000000001
10100110000010000001001011100010000110010000000110100000001000000011010011001010001C1011000100100001
1000000000010011011000000000101000000000000000001000010000001000010010100011000100110101010001000111
1010100000111000000101010011000011001000001110001100100001000101001100110000000011100010000000000001
1011000110100110000001001000000111000000101110C10000010100110001001100110000000100001010101001C11001
1101000011100000000000000000100110000000000000000000100100100001100111001100000100000000010100011011
1000010001111010011000001011000000001001000011100000100000000001101001000011100000110110111100001001
10100100000100000110010000001000010001001001C1100010010001010101000010000110000111100100010000010101
1000100010010100001000000001100010101001000000100010001000011000110110011001000000110000010010010001
1010000000000100001110000010001010100101101000001001010000100000010000100101110010001000010101100001
1000001011010011000000000111000110101010001000110000000010000010010100010001011000010100100001000001
1100100100001011010100100000001100010100001000100010000100011001000001010000100000000000000001000001
100100000P000010010000000110100011010100110010010000100000000010000000010011001010000100011011110101
10100100110011001000100001001000101000100000100000010001101011110000110101010C0011001001010000000001
1000000011000101000010001000000000010000100010011000001010001000001000000010001001011000010101100001
1000100001001111001011100111110000010010001001011000101010001000110001011110111010010100001000110001
1000001011010010010101001001100000001000000101101000010101000111001001100010001000100000000010001001
1100001001001000010000111100100010000010010001000011001100000100001010000001001000000000010100110111
100000000000111000100101000011000001110C100101001000000100101000100000100101000100100100111000000001
100001100100001101100010010000111010001011C000110010C00010C011010111010101C1011010100001100000110111
1000110110001100010000010000110001100000100001000010001000001000101000000100001011000000000001100101
1000001100100100100000001101010100000000001001001110001001011001010010000100000010000010110000000001
1001100110010001001100000111001100000000000110000000110001001110000010110101000000111100000100001001
1000011000111100010100100110100000001010001001000011011000100010000000100010010001100110001001001001
101001010010011001001000100100010C000101010100100010000000110011011011100010100001101100010000100011
110011000100110000001000000010100001100100100000C010001110000100100110001000001010010001100101100101
10101000001111000010C000100000010110000000001110000100011101110100000001001100100000001000100C000001
1001100000011110100101001101001100010000000001101010001010000001000010111000001100111000111000100001
1100100000101011100100010001000001000000000001010000010C01000000000001100000100100010100001000100001
1001000000001010100001000010001001000000000001001001001110010000010001000000000000000100101000010101
1100010010110100011000000100000000100000001000000101010110010000001000001011100110000110100000011001
1010011000100001100010001100001000000000110001001000101000010101100000101000000000000010010010010001
1000000000000001010100110010000100001101000010001010000001000010010000000000000101C00000001010000011
1001001100000010001011000000011100001000001000111000100000000000010011000101100010011000011100001001
1000111100000101101010000000000100110001111000001000010001001110000001010001101100100000010100000011
10110101000001000010011000101110001000000110101000110001001010001000000101000000110C0100010000100011
1001001000000101000011000000000000011011010001000000000000010000101100100010110001001000101100011111
1000100010000010100100000000010001000000000010011111001001101101100000001110001001000100001000001011
1000000001000100001100010000000000001100100010101000000010000001000010010000000001000000000100000001
1001000100011101100100000000110000000001000011111000000010100100101000010000101000000000011010000111
100000001110000000001C010100000100010000100010010011111111010000001100000010110100110000100100101101
1101110000111100011101101011010011001010001010001000010001100000000011001000000010010000010010000001
1011100001001011010000000000000000000100010100100001111000000000000000000101000001C00110000001100001
1001000000010100000000101000000101000010010011000010000110001010100010001001101001001100000001100001
110110000101110011C000000100100001000000000010011101000000001000010000000001000000001110010000000011
1000101010011011000010000000000010110100000001000C000110001110000010101001001010100010100000C1000011
100000000001001100001011001010000000111000011110100001100000000000010000000010000C101101111010000101
1010110000001000000000001000100000100000000000000101010001001100101000001000000010010000010100100001
1010111101101010101101101100100001100011100001000100000000000010010000000101000000100000010010100011
1000001000110101100000100000001110100010000000010100001101110110100001001001000000101010010101000011
1001100110000001000001000000001001010110000010100000000100111110101010101000010101000011010100100001
1100101100000000100000011000010000110001100100000011000001101010001000100111011000001000011100000001
10010001001000C0100010101100100100110001100101000000110001000000000101001101000000010001000011101001
100011010010100000000001100000101000101111000010010001000000C001011001000000100000011100101100010011
1000000001000100011011000010000011010101010000000001000011101000000000000000001001001001101100000001
1011000010010000000110100000100010010010101100000001010010100000111000001001100000110001001100100001
1100011111010000110001000000010110100011000100010000100001010001001000000100011101000000000000000101
1011010000100000110000001011010001000001000100011001000000001000000100010000100001001011000110000011
1101100000110001101000000010000010000111000011100000101000010000110000100000010000011100000000001101
1001000010000000101011011010001000001010000010000001111011000101001000010000010010001101000101000111
11110000000001101011100110100C0100100001000010100000100000100000001001101000111100000000000000010001
1000100001000101100101101C01000100000001000100001000100001010010100000000100011000001E10000001110001
1000111100011011100000000100011011000100000011101000010000101000010100010010000000000000011000110101
1110001000010010001100000011110000000101100000000010011000001011000000010111000000000011000100010101
1000010001001010010010001010111110001000100000000100000000010100101101001101101001010100000C00011001
1100100010101000001001011100111110000101101000101100000001001100000000001011100111000000100000100001
1000000010010010010010000001100010000011010100111010010100001010011010010110001000000010000000001101
1000011010000001101100000010001100011000000010010000000000010110000010000001010011001010010000000011
10000000010110000100000101000000000001000000100100001011110010100C1001111010000001000000001000101001
1100000000100001010100011110000000101000110000000000001000000101110000000000000000000110010100111101
100100100000010C0010000001C1010000010010000110100101000000000100111010011000000111010110101100100001
1000010101100001000000010101110000000100000000101000010001000010010010C000110100000001C0010010110101
1000C0000000000000111001001000001011C000010001000101000010000010000100110010010010000000000000000101
1000100000011101000000001010100010010010000010C00010001010111011110000000101010100010001000010000001
1000000011000000110010001000001010000001100110001000010011000100C000010000C0000000110111000000001011
1110001001000010010000000001000000001101010010100001000000111101001011011000000001C01000010010000011
1011010000011000100101100001011011001100001001000101111100011100110000001110000000110000010111010001
1000010010101100000000100010010010111001011000001010100110011100110010101001101100111010001101100001
110001010000101C001100011100100000100000001101010001011100000001010100000001010100000000100100000001
1000001001010000000010010100110111000010101100010110011000011100011000011100010100101000000010000001
1000111000000000000010110000101C01010000001100110100100000000000010010001000000000000000010001100011
11000101011101000000010100010000000010001001000110000010000000000000101001C0010000000010000011001001
1000100010000110010010001011001010000001010000000000111000010001011000101000001010000000100011000101
1010100001011001011100000011011010001001000001001000000011010010000000000000001100000001000011010001
11000001101011000001001000000010000000100110110000000000000000111101010111010100000010000110000C0101
1000101000101000010001010111100011100100100101010011001000011010110010010011100001100000101000010001
1000000001000001000100100110000001001000100010010110001000100000010011101001001000000011011100000001
1011010001111110100000000000110000000000000011000110010011000001010000110000000C00100000110001000001
1000010000111001010101111100001000100110101000000001100000111001100100111001100000100010101110000001
1001010000000001000100101011100001000001001000000010101010000000100000010001011C00000000010101000001
1111111111111111111111111111111111111111111111111111111111111111111111111111111111111111111111111111
