1111111111111111111111111111111111111111111
1110110100000100001000000101101010001100001
1110010001110001001010101000000000101000001
1000001111000001100110001111001001010000111
1100011000010010000011101001110100000001111
1011101000001010000010010011000010010001001
10000000110101000001010110100011110C0100101
111000C00000100001100100C100100001100100001
1010001100100010000000000C01001000011000101
1100000011100100000C00000110000100100001111
1001000000110000100000C10010011010000000001
1010001100000010000001000C01000000000000001
1000000010C10100000101000000000001000010001
1001000000000101000001011001001011011000C01
1011010001011000001010100100010101100001101
101010000100001101C010010000010100010000111
10001000010101000000000101C0000001010100011
1000100010010100011010010000100000000101101
1000100000100000100000100000000100110000001
1110001010100000110010110010100000000000111
1000001010100110000100000001000000C1010C001
1111001000101000000000000000010001101001001
100100110C000001000010100001000000001000111
10000011110100011C10000010001000C1100001011
1010001011001000000010000000100100010101001
1001C00011001000110000010011100000011100001
1101110010010001000000000000010000C11000011
1010001001110000010001001010100100101000111
11100001000C1100001010101010100101000000001
1000010010110011000010001100110010000001001
1011100000010001000000000000010101000000011
1000111100000011101111010010101111010000101
1110000000100010101000000000001000100000001
1001110000000000000000010000100000100101101
1000011000010000100100111100000000000010001
1010001C10001010001000010000011101100100001
1001010000000000001010100100000110010100111
111001101010110010110010001P000011011000001
1001011010101C00001000101110001000000001011
1010000010101100000000C0000000C010001100111
1000100100010010000000100100001000000000001
1101000101110001000000000110001100001101011
1C00001000010000100110000101100101010000011
1001000001000001000000001001011100000000001
1010001100000010001010010010010011000001001
101010000100000000100000001100001000010C001
100000000001C0001100000000001100000100000C1
1000000001001000001111000000000111000011101
100000000000110001000101011011001C100010001
10000000100010010111C0000110001001001000111
1000010000010000001100111100001011000111001
10010000010100111000000000100110010C1001001
10001C0001001100000110101010100011100000011
1011001000000010001000010010001000000100101
1010010001010100001100011000110110100010001
110111100000C001010011000000010000101101001
1000110001000000000001010101000010000000001
100C001010101000010000010110000000011000111
10000000101000000C0000000011000000001011001
1000100110101100011011CC0000100010000001001
11001000000100100100000100000001000C0010001
100000000000000010C000010000010011000000001
1000011C01110010000111010100100000010000011
10C0000000010010101011001000000010000001101
110101100000001000000C000000001111101000001
1010100010000001000000011100110110010000001
100000101011010000101000000C100001000000001
110000000010000001000000000000C011000000001
1C10010001000100100110000000110111001000001
10100111100001000C00001000C0000000000010001
1000000000100001000000001111010011010100001
1001101110101000010100000011011101010000E01
1010011100010010001000010101100000101C00011
110000000000101000000001010110C101011001001
1011110010101110110010000C00000100C10100001
1111111111111111111111111111111111111111111
