1111111111111111111111111111111111111111111111111111111111111111111111111111
1101001111010110C00000100011000100010000000010100011010010100100101110000111
1000100111000011001000101100010000010001110001100C000000001C0111011001001001
1C00000000010001000001000010100100100100010000011100C00010000101110100100111
10011110000000000000000100110110000C0100000100000C0000011001111110110C011101
10001000C00010010110001000011100000010001C0010010000111100110110001000000101
1000101110111111100011111011010100010011111000000101010000100100100000000011
1111001001001001101000001100001000001101100100011001100000000001001100000001
1000001000100000001000001000010111010010001000010011000000111000001101001101
10010111000010000010001000001011000010C1001100100010000110001001100100C00001
110100001C100010100100001001000001001000110001000001110000000001000000000001
11100C000101100111110101000000C0000010001000000000100110C0011000010010000001
1C11010111010110001000100110111000000101000101000110110010000000011000000001
10011000100000000010010010110000000111101000000000001000C1100000000100010111
1001100000000000100100C000100010011101000100001001101000010001C0001110000111
110010C000000000011001000001001000011011100001001100001101000101000000100001
1000010000001000100010001000000010001011000101001E01001000111000000000001101
1010100100011001001C000100010001100000100000001001000000101000111011CC010011
1001010100101000010100000001100110000000000101000110100000C0000010C000000011
1100100101100010000000111101000001101110000010000000100100000001111010000001
1000101011000100000011000000000010100101000C1010000010110000100010001C000001
10101001101000011001000C0110100001000000011010000000010010001000101000C10001
100000100001000C00000001001101000100111000101011001101000000C001000010100001
1000000001000001001000001000000000101101010010100000001000100110001100001001
110000100010010001000000101010000010000011000000100000C000011000001101100101
1010000000C00000000001000011001100010C000100010000000000001000000000100C0001
1001001000010010010000001011000001010101000000010000001000000100101111000001
1110100000010001100010000001111100000000110001010001110000C000C0100101010001
1011010010001000000011100100100000010000100000001010000000C00000001001000011
1010011100000000001001000C0000110000110001001101101C001010000000001110000101
10010010110000000000000011001000110100001011111000000010000100C0000001001101
100000000000100001000001100101100100000111000001C000010000000000100010000001
1000000001000000C00000110000100110011101011010010100000100110111000000011001
1000000110011010000010100011000000110000000110010100000110010000000000011111
11110001001000000000001000C010101000000C100010100010000101110001000110011001
10011000C0001000000001110100000000C00011000001000011010010101100111010000001
1000010000010110101000000000010010000001000000001000110001101000001000000001
100100010011111100011110000000000100110P000001100000011010110000010000010001
1000000101010010110001100000011100001010100000000100000110001000000000011101
1011011110000101101000000010101000101011101000101000100111100000011000000001
10000100000100011000100000010100101000011001000000100001C01C0000001010000001
1001100001011000100000000000100000101100100000010010110010011010010000100001
1111111111111111111111111111111111111111111111111111111111111111111111111111
